     E
---    ----------------------------------------------------------------
| |         |     |     |   |       |     |     |     |         |     |
| | ------- | --- | --- | | | ----- | --- | --- | --- | ------- | --- |
| |     |   |   |     | | |     |   |     |   |     |     |   |     | |
| --- | | ----- ------- | ------- | ------- | ------- | | | ------- | |
|   | | |   |       |     |     |     |   |     |   | | | |     |   | |
| | | | | | | ----- | --- | --- | --- | | | --- | | | | | | --- | | | |
| | | |   |     |     |   |   | |   | | |     | |   | | | |   |   | | |
| | | ------- | --- | ------- | | | | | --- | | --- | | | | ------- | |
| |         | |     |     |   | | | | |     | |     | | | |   |       |
| --------- | | ------- | | --- | | | ------- | ----- | | | | | ------- 
|       |   | |       | | |     | |         | |       |   | | |       |
| --- | | --- ------- | | | ------- ------- | | ------- --- | | --- | |
| |   | |   |     |   |   | |     |       | | |   |   |     | | |   | |
| | --- --- | --- | ------- | | | | ----- | | --- | | ------- | | | | |
| |   |     |   | |       | | | | |   |   |     | | |   |     | | | | |
| --- | --- --- | --- | | | | | --- | | ------- --- | | | --- | | | | |
|     |   |     |   | | | | | |   | |     |   |     | | | |   | | | | |
| --- | | | --- --- | --- | | | | | --- | | ------- | | | | --- | | | |
| |   | |   |   |     |   | | | | | |   | |     |     |   |     | | | |
| | --- --- | | --- | --- | | | | | | | | --- | | ------- ------- | | |
| |   |     | |   |     | | | | | | | |   | |   |     |   |       | | |
| | | | ----- --- --- | | | | | | | | --- | --- --- | | --- | --- | | |
| | | |     |   |   | | | | | | | |     | |       | | |   | |     | | |
| | | --- | | | | | --- --- | | | ------- --- --- --- | --- | --- | | |
| | |   | | | | | |   |     | | |       |     |   |     |     | | | | |
| | --- | | --- | --- | --- | | | ------- --- | | | ------- --- | | | |
| |   | |     |     |   |   | |         |     | |   |     |     | | | |
| --- | --- | ------- | --- --- ------- | ------- | | | --- | --- | | |
|     |     |     |   |     |         |     |   | | |   |   |   | | | |
| ------- | | --- | --- --- | ------- --- | | | | | --- | --- | | | | |
|   |     | |   |     |   | |     |   |   | | | |     |     |   | | | |
| | | --- --- --- | --- | --- | | | | --- | | | | --- ------- --- | | |
| |   |   |     | |     |   | | |   | |   | | | |   |     |       | | |
| --- | | | --- --- | --- | --- --- --- | --- --- | | | | | ------- | |
|     | |     |   |     |     |         |         | | | | |   |     | |
| --- ------- | | | --- ------- --------- --- --- --- | | --- | | --- |
| |       |   | |     |     |   |     |     | |   |   | |   | | |   | |
| | --- | --- --- --- --- | | | | | | | --- | | | | --- --- | --- --- |
| |   |   |       |     | | | | | | | |   | | | | |       |     |     |
-----------------------------------------------------------------   ---
                                                                  S  
